......................
....@@@@@.............
........@.....@@@.....
........@......@@@....
........@......@@@....
........@.............
......................
..........@@@@@.......
......................
@@@@........@.........
@@@@@.......@.........
............@.........
............@.........
......................
......................
